PWWWWWWWWWWWWWWWWWWW
       WWW         W
W      WD          W
W      WWW         W
W          W       W
W          TDT     W
W                  W
W                  W
W                  W
WWWWWWWWWWWWWWWWWWWW
