PWWWWWWWWWWWWWWWWWWW
       WWW         W
W      WD          W
W      WWW         W
W                  W
W          T       W
W                  W
W                  W
W                  W
WWWWWWWWWWWWWWWWWWWW
