PWWWWWWWWWWWWWWWWWWW
       WWW         W
W      WD          W
W      WWWW        W
W         WWWW     W
W        TT DW     W
W          WWW     W
W                  W
W                  W
WWWWWWWWWWWWWWWWWWWW
