 WWWWWWWWWWW        
WW         W        
W  WWWWWWWTWW       
W W       T WWW      
W WDDDBBBDBDP W     
W W       T W W     
W  WWWWWWWTW  W     
WW        T  WW     
 WWWWWWW    WW      
	   WWWWWW       
