	   WWWWWWW      
	WWWW     WWW    
	W  TT W T  W    
	W WW W  WW W    
	W W   T  W W    
	W W  DD  W W    
	W WW DD WW W    
	W WWWWWWWW W    
	W         PW    
	WWWWWWWWWWWW    
