  WWWWWWWWWW        
 WW        WW       
 W  WWWWWW  W       
 W W   W  W W      
 W W B   B  W       
WW WWB BTD  W       
W  WW   W WWW       
W W   WB T  W      
W  BBB B D  W       
WWW    WW  WW       
  W    PWWWW       
  WWWWWW           

