WWWWWWWWWWWWWWWWWWWW
W      WWW         W
W      WDP         W
W      WWW         W
W                  W
W          T       W
W                  W
W                  W
W                  W
WWWWWWWWWWWWWWWWWWWW
