WWWWWWWWWWWWWWWWWWWW
P      WWW         W
W      WD          W
W      WWWW        W
W         WWWW     W
W       T T DW     W
W          WWW     W
W                  W
W                  W
WWWWWWWWWWWWWWWWWWWW
