WWWWWWWWWWWWWWWWWWWW
W      WWW         W
W      WD          W
W      WWW         W
W                  W
W       P  T       W
W                  W
W                  W
W                  W
WWWWWWWWWWWWWWWWWWWW
