....................
WWWWW...............
W.  W...............
W PTW...............
WWT WW..............
WW T W..............
WDT  W..............
WDDBDW..............
WWWWWW..............
